1111111111111111111111111
1P01000000C00000000000000
1001C11011111111111111101
1C01000010000000000000C01
10111110100110000CC000001
100100001C111111110111111
10C11001100000C00001010C1
1001000011111011111100011
11000C0C1C0C00000000000E1
1111111111111111111111111