11111
10001
1P0C1
11111
111E1
11111