1111111
1P00001
1010101
10C1101
100CC01
1111101
1CE1101
1000001
1111111