1111111111111111111111111
1001000000C00000000000001
1001C11011111111111111101
1C01000010000000000000C01
101111101001100000C000001
100100001C111111110111111
10C11001100000C0000101001
1001000011111011111100011
11000C0P100C00000000000E1
1111111111111111111111111