1111111
1P00011
1000001
1CC0001
1000001
10000E1
1111111