1111111111111
1P000C00C0001
101C1C1C1C1C1
1010101010101
1010111001101
10111111111E1
1011110000001
1000000111111
1111111111111
