1111111111111
1C000C00C0001
101C1C1C1C1C1
1010101010101
1010111001101
10111111111E1
10111110000C1
1000000111111
1000P00111111
1000000111111
1000000111111
1000000111111
1000000111111
1000000111111
1000000111111
1000000111111
1111111111111
